[
  {
    "type": "mapgen",
    "method": "json",
    "om_terrain": [ "smart_research_lab_nw" ],
    "weight": 400,
    "object": {
      "fill_ter": "t_concrete",
      "rows": [
        "||||||||||||||||||||||||",
        "|......................|",
        "|..c.......|...........|",
        "|..c.......|...........|",
        "|..........+...........|",
        "|..........|...........|",
        "|..........|...........|",
        "|..........|...........|",
        "|..........|...........|",
        "|..........|...........|",
        "|..........|...........|",
        "|..........|...........|",
        "|..........|...........|",
        "|..........|...........|",
        "|..........|...........|",
        "|..........|...........|",
        "|..........|...........|",
        "|..........|...........|",
        "|..........|...........|",
        "|..........|...........|",
        "|..........|...........|",
        "|..........|...........|",
        "|..........|...........|",
        "||||||||||||||||||||||||"
      ],
      "terrain": {
        "|": "t_wall_w",
        "+": "t_door_c",
        ".": "t_concrete"
      },
      "furniture": {
        "c": "f_counter"
      },
      "place_items": [
        { "item": "tools_mechanic", "x": [ 2, 6 ], "y": [ 2, 6 ], "chance": 80, "repeat": [ 1, 3 ] },
        { "item": "electronics", "x": [ 2, 6 ], "y": [ 2, 6 ], "chance": 70, "repeat": [ 1, 2 ] }
      ]
    }
  },
  {
    "type": "mapgen",
    "method": "json",
    "om_terrain": [ "smart_research_lab_ne" ],
    "weight": 400,
    "object": {
      "fill_ter": "t_concrete",
      "rows": [
        "||||||||||||||||||||||||",
        "|......................|",
        "|..t........t..........|",
        "|..t........t..........|",
        "|..t........t..........|",
        "|..t........t..........|",
        "|..t........t..........|",
        "|..t........t..........|",
        "|..t........t..........|",
        "|......................|",
        "|......................|",
        "|......................|",
        "|......................|",
        "|......................|",
        "|......................|",
        "|......................|",
        "|......................|",
        "|......................|",
        "|......................|",
        "|......................|",
        "|......................|",
        "|......................|",
        "|......................|",
        "||||||||||||||||||||||||"
      ],
      "terrain": {
        "|": "t_wall_w",
        ".": "t_concrete"
      },
      "furniture": {
        "t": "f_table"
      },
      "place_items": [
        { "item": "office", "x": [ 2, 20 ], "y": [ 2, 18 ], "chance": 80, "repeat": [ 2, 5 ] }
      ]
    }
  },
  {
    "type": "mapgen",
    "method": "json",
    "om_terrain": [ "smart_research_lab_sw" ],
    "weight": 400,
    "object": {
      "fill_ter": "t_concrete",
      "rows": [
        "||||||||||||||||||||||||",
        "|......................|",
        "|......................|",
        "|..c.......c...........|",
        "|..c.......c...........|",
        "|..c.......c...........|",
        "|..c.......c...........|",
        "|..c.......c...........|",
        "|..c.......c...........|",
        "|......................|",
        "|......................|",
        "|......................|",
        "|......................|",
        "|......................|",
        "|......................|",
        "|......................|",
        "|......................|",
        "|......................|",
        "|......................|",
        "|......................|",
        "|......................|",
        "|......................|",
        "|......................|",
        "||||||||||||||||||||||||"
      ],
      "terrain": {
        "|": "t_wall_w",
        ".": "t_concrete"
      },
      "furniture": {
        "c": "f_chest"
      },
      "place_items": [
        { "item": "electronics", "x": [ 2, 14 ], "y": [ 3, 8 ], "chance": 70, "repeat": [ 1, 3 ] }
      ]
    }
  },
  {
    "type": "mapgen",
    "method": "json",
    "om_terrain": [ "smart_research_lab_se" ],
    "weight": 400,
    "object": {
      "fill_ter": "t_concrete",
      "rows": [
        "||||||||||||||||||||||||",
        "|......................|",
        "|......................|",
        "|......................|",
        "|......................|",
        "|......................|",
        "|......................|",
        "|......................|",
        "|......................|",
        "|......................|",
        "|..c...................|",
        "|......................|",
        "|......................|",
        "|......................|",
        "|......................|",
        "|......................|",
        "|......................|",
        "|......................|",
        "|......................|",
        "|......................|",
        "|......................|",
        "|......................|",
        "|......................|",
        "||||||||||||||||||||||||"
      ],
      "terrain": {
        "|": "t_wall_w",
        ".": "t_concrete"
      },
      "furniture": {
        "c": "f_armchair"
      },
      "place_items": [
        { "item": "science", "x": [ 10, 12 ], "y": [ 10, 12 ], "chance": 100, "repeat": [ 1, 2 ] }
      ],
      "place_npcs": [
        { "class": "smart_research_male_npc", "x": 12, "y": 11 }
      ]
    }
  }
]
