[
  {
    "type": "mapgen",
    "method": "json",
    "om_terrain": [ "smart_vehicle_testing_ground_nw" ],
    "weight": 400,
    "object": {
      "fill_ter": "t_concrete",
      "rows": [
        "||||||||||||||||||||||||",
        "|......................|",
        "|......................|",
        "|......................|",
        "|......................|",
        "|......................|",
        "|......................|",
        "|......................|",
        "|......................|",
        "|......................|",
        "|......................|",
        "|......................|",
        "|......................|",
        "|......................|",
        "|......................|",
        "|......................|",
        "|......................|",
        "|......................|",
        "|......................|",
        "|......................|",
        "|......................|",
        "|......................|",
        "|......................|",
        "|...................... "
      ],
      "terrain": {
        "|": "t_chainfence",
        ".": "t_concrete"
      },
      "place_item": [
        { "item": "corpse", "x": [ 2, 22 ], "y": [ 2, 22 ], "chance": 40, "repeat": [ 0, 3 ] }
      ]
    }
  },
  {
    "type": "mapgen",
    "method": "json",
    "om_terrain": [ "smart_vehicle_testing_ground_n" ],
    "weight": 400,
    "object": {
      "fill_ter": "t_concrete",
      "rows": [
        "||||||||||||||||||||||||",
        "|......................|",
        "|......................|",
        "|......................|",
        "|......................|",
        "|......................|",
        "|......................|",
        "|......................|",
        "|......................|",
        "|......................|",
        "|......................|",
        "|......................|",
        "|......................|",
        "|......................|",
        "|......................|",
        "|......................|",
        "|......................|",
        "|......................|",
        "|......................|",
        "|......................|",
        "|......................|",
        "|......................|",
        "|......................|",
        "|...................... "
      ],
      "terrain": {
        "|": "t_chainfence",
        ".": "t_concrete"
      },
      "place_item": [
        { "item": "corpse", "x": [ 2, 22 ], "y": [ 2, 22 ], "chance": 40, "repeat": [ 0, 3 ] }
      ]
    }
  },
  {
    "type": "mapgen",
    "method": "json",
    "om_terrain": [ "smart_vehicle_testing_ground_ne" ],
    "weight": 400,
    "object": {
      "fill_ter": "t_concrete",
      "rows": [
        "||||||||||||||||||||||||",
        "|......................|",
        "|......................|",
        "|......................|",
        "|......................|",
        "|......................|",
        "|......................|",
        "|......................|",
        "|......................|",
        "|......................|",
        "|......................|",
        "|......................|",
        "|......................|",
        "|......................|",
        "|......................|",
        "|......................|",
        "|......................|",
        "|......................|",
        "|......................|",
        "|......................|",
        "|......................|",
        "|......................|",
        "|......................|",
        "|...................... "
      ],
      "terrain": {
        "|": "t_chainfence",
        ".": "t_concrete"
      },
      "place_item": [
        { "item": "corpse", "x": [ 2, 22 ], "y": [ 2, 22 ], "chance": 40, "repeat": [ 0, 3 ] }
      ]
    }
  },
  {
    "type": "mapgen",
    "method": "json",
    "om_terrain": [ "smart_vehicle_testing_ground_w" ],
    "weight": 400,
    "object": {
      "fill_ter": "t_concrete",
      "rows": [
        "|.......................",
        "|......................|",
        "|......................|",
        "|......................|",
        "|......................|",
        "|......................|",
        "|......................|",
        "|......................|",
        "|......................|",
        "|......................|",
        "|......................|",
        "|......................|",
        "|......................|",
        "|......................|",
        "|......................|",
        "|......................|",
        "|......................|",
        "|......................|",
        "|......................|",
        "|......................|",
        "|......................|",
        "|......................|",
        "|......................|",
        "|...................... "
      ],
      "terrain": {
        "|": "t_chainfence",
        ".": "t_concrete"
      },
      "place_item": [
        { "item": "corpse", "x": [ 2, 22 ], "y": [ 2, 22 ], "chance": 40, "repeat": [ 0, 3 ] }
      ]
    }
  },
  {
    "type": "mapgen",
    "method": "json",
    "om_terrain": [ "smart_vehicle_testing_ground_c" ],
    "weight": 400,
    "object": {
      "fill_ter": "t_concrete",
      "rows": [
        "|.......................",
        "|......................|",
        "|......................|",
        "|......................|",
        "|......................|",
        "|......................|",
        "|......................|",
        "|......................|",
        "|......................|",
        "|......................|",
        "|......................|",
        "|......................|",
        "|......................|",
        "|......................|",
        "|......................|",
        "|......................|",
        "|......................|",
        "|......................|",
        "|......................|",
        "|......................|",
        "|......................|",
        "|......................|",
        "|......................|",
        ".......................|"
      ],
      "terrain": {
        "|": "t_chainfence",
        ".": "t_concrete"
      },
      "place_item": [
        { "item": "corpse", "x": [ 2, 22 ], "y": [ 2, 22 ], "chance": 100, "repeat": [ 2, 5 ] },
        { "item": "decision_control_boss_end_wheel", "x": 13, "y": 12, "chance": 100 }
      ],
      "place_vehicles": [
        { "vehicle": "boss_end_wheel", "x": 12, "y": 12, "chance": 100, "fuel": 100, "status": 0, "rotation": 0 }
      ]
    }
  },
  {
    "type": "mapgen",
    "method": "json",
    "om_terrain": [ "smart_vehicle_testing_ground_e" ],
    "weight": 400,
    "object": {
      "fill_ter": "t_concrete",
      "rows": [
        ".......................|",
        "|......................|",
        "|......................|",
        "|......................|",
        "|......................|",
        "|......................|",
        "|......................|",
        "|......................|",
        "|......................|",
        "|......................|",
        "|......................|",
        "|......................|",
        "|......................|",
        "|......................|",
        "|......................|",
        "|......................|",
        "|......................|",
        "|......................|",
        "|......................|",
        "|......................|",
        "|......................|",
        "|......................|",
        "|......................|",
        ".......................|"
      ],
      "terrain": {
        "|": "t_chainfence",
        ".": "t_concrete"
      },
      "place_item": [
        { "item": "corpse", "x": [ 2, 22 ], "y": [ 2, 22 ], "chance": 40, "repeat": [ 0, 3 ] }
      ]
    }
  },
  {
    "type": "mapgen",
    "method": "json",
    "om_terrain": [ "smart_vehicle_testing_ground_sw" ],
    "weight": 400,
    "object": {
      "fill_ter": "t_concrete",
      "rows": [
        "|.......................",
        "|......................|",
        "|......................|",
        "|......................|",
        "|......................|",
        "|......................|",
        "|......................|",
        "|......................|",
        "|......................|",
        "|......................|",
        "|......................|",
        "|......................|",
        "|......................|",
        "|......................|",
        "|......................|",
        "|......................|",
        "|......................|",
        "|......................|",
        "|......................|",
        "|......................|",
        "|......................|",
        "|......................|",
        "|......................|",
        "||||||||||||||||||||||||"
      ],
      "terrain": {
        "|": "t_chainfence",
        ".": "t_concrete"
      },
      "place_item": [
        { "item": "corpse", "x": [ 2, 22 ], "y": [ 2, 22 ], "chance": 40, "repeat": [ 0, 3 ] }
      ]
    }
  },
  {
    "type": "mapgen",
    "method": "json",
    "om_terrain": [ "smart_vehicle_testing_ground_s" ],
    "weight": 400,
    "object": {
      "fill_ter": "t_concrete",
      "rows": [
        "....................... ",
        "|......................|",
        "|......................|",
        "|......................|",
        "|......................|",
        "|......................|",
        "|......................|",
        "|......................|",
        "|......................|",
        "|......................|",
        "|......................|",
        "|......................|",
        "|......................|",
        "|......................|",
        "|......................|",
        "|......................|",
        "|......................|",
        "|......................|",
        "|......................|",
        "|......................|",
        "|......................|",
        "|......................|",
        "|......................|",
        "||||||||||||||||||||||||"
      ],
      "terrain": {
        "|": "t_chainfence",
        ".": "t_concrete"
      },
      "place_item": [
        { "item": "corpse", "x": [ 2, 22 ], "y": [ 2, 22 ], "chance": 40, "repeat": [ 0, 3 ] }
      ]
    }
  },
  {
    "type": "mapgen",
    "method": "json",
    "om_terrain": [ "smart_vehicle_testing_ground_se" ],
    "weight": 400,
    "object": {
      "fill_ter": "t_concrete",
      "rows": [
        ".......................|",
        "|......................|",
        "|......................|",
        "|......................|",
        "|......................|",
        "|......................|",
        "|......................|",
        "|......................|",
        "|......................|",
        "|......................|",
        "|......................|",
        "|......................|",
        "|......................|",
        "|......................|",
        "|......................|",
        "|......................|",
        "|......................|",
        "|......................|",
        "|......................|",
        "|......................|",
        "|......................|",
        "|......................|",
        "|......................|",
        "||||||||||||||||||||||||"
      ],
      "terrain": {
        "|": "t_chainfence",
        ".": "t_concrete"
      },
      "place_item": [
        { "item": "corpse", "x": [ 2, 22 ], "y": [ 2, 22 ], "chance": 40, "repeat": [ 0, 3 ] }
      ]
    }
  }
]
